############################################################
###########       ##########################################
#############        #######################################
################            ################################
####################            ############################
####################            ############################
#############################                       ########
##################################                  ########
#############################################          #####
###############################################        #####
#############################################       ########
#############################################       ########
###########################################       ##########
################################             ###############
##############################               ###############
#####                                #######################
#####                                #######################
########################       #############################
##########################          ########################
################################               #############
#######################################                 ####
#######################################                 ####
###############################################      #######
##############################                     #########
#########################                          #########
############                 ###############################
############                 ###############################
############################################################
############################################################
############################################################